X

1859. Asplenium yermam'cum: P. A. Karsten, Ab3 (antea jam indicavit Fr. Ny-
land er .
Careoe pedgformis: Th. Simming, St; (antea jam indicavit Fr. Nylander).
Pulsatilla patens: Kl. Wahlman‚ Ta3 (ex Ik antea jam indicavit W.
Nylander et alii, primus in Fennia leg. J. G. Appelberg).
Thalictrum aquilegicefolium.· H. Backman‚ Kl.
Ramex maritimus: idem⁷ Kl.
Callitriclze polymorpha: Th. Saelan, Sa.
1861. Sparyanium lzyperboreum: N. Ι. Fellman, Lr.
Arabis petraea: G. Selin, On.
Potenlilla nivea: idem, Im3 (e Le prius indicavit J. Fellman).
Crepis prcemorsa: C. J. Arrhenius, Ta,
Malva vulgaris: B. Alfthan, Ka.
1862. Ico'e'tes echinospora: Al. Braun (primus in Fennia leg. E. V. N iklander).
Poa compressa: A. Zetterman, Ab3 (antea jam e Fennia australi indicave-
runt E. Fries et N. J. Andersson).
Ffflilobium roseum: idem, Ab.
Ruppia brachypus: C. J. Arrhenius, Ab.
chenopodium hybridam: A, E. Brander, Ab ; (antea jam indd. E. Fries et alii).
Geranium molle: Kl. WVahlm an, Al,
Senecio viscosus: M. Brzznxmr, Ka.
1863. Viola stamina: J. A. Fastberg‚ Kl,
lealietrum anyzlstif'olium: Th. Simming, On.
Pheqopteris Robertiana: idem, On.
Epipaclis abror-iibens: idem, On.
Eriophorum canithi-im: N. Ι. FeHman, Lp.
Poa ccesia: idem, Lp; (nomine P. ylaucce e Li olim indicavit J. Fellman).
Astraqalus oroboiclcs: idem, Lp3 (e Li antea jam indicaverunt G. Wahlen-
berg et J. Fellman),
Calamayrostis clesclzampsioizles: idem, Lp.
Triticum violaceum: idem, Lt.
Nziphm luteum >< pumilum: idem, Lr3 (sec. specimina a J. Fellman collecta3
e Lt antea jam iudicavit C. F. a. Ledebour).
Chrysflosplenizmz tetraizclrum: idem3 (primus leg. J. Fellman‚ Li et Lt; e Li
antea jam indicavit Th. Fries),
Silene tatarica: idem3 (specc, jam anno 1827 leg. J. Fellman‚ Im3 auno
1788 in Lkem leg, G1·'('›n‹]al see. G. Wahlenberg).
Paeonia anomala: N. Ι. Fellman & M. Brenner‚ Lp3 (antea jam leg. et
indicavit ibidem v. Baer).
Gentiana tenella: iidem, Lp3 (antea e Fennia indd. Gunnerus et J. Fell-
man, Li δε Lt).
Gypsoplzila sastiqiata: M. Brenner et N. J. Lam-in, Im3 (antea e Fennia
orient. indd. F. J. Ruprecht, W. Nylander et alii).

 

Angfiende fcljande hybriders fiirekomsn inom doute aussi en decades limites (le notre flore. Il

floromrfidot finnas stfvon siikra uppgifter: y a encore ‹l’indications ssn'es pour leshybrides

Sabim caprea >< Lapponum, S. hastata >< ΜΨ· suivants: Salia: caprea >< Lapponum, S. lia!

tilloides, S. Lapponum >< niyricans, Viola mi- stata >< myrffilloicles, S. Lappomlm >< niyri-

rabilis >< Rivmiana, Epilobiwn damn-icum >< cans, Viola mirabilis >< Riviniana, Epilobzum

palustre, Ε. (lavuricam >< laclislorum. J}“²‘’²‘''i⁰²⁴”² >< palustre, E. (lavaricum >< lacti-
ormn.

